11 15 0 3
2 2 2 2 2 2 2 2 2 2 2 2 2 2 2 
4 3 3 3 3 2 2 3 3 3 3 2 2 0 2
2 3 2 2 3 2 2 3 2 2 3 2 2 3 2
2 3 2 2 3 3 3 1 2 2 3 3 3 3 2
2 3 3 3 3 2 2 3 3 3 3 2 2 3 2
2 3 2 2 3 2 2 3 2 2 3 2 2 3 2
2 3 2 2 3 3 3 3 2 2 3 3 3 3 2
2 1 3 3 3 2 2 3 3 3 1 2 2 3 2
2 3 2 2 3 2 2 3 2 2 3 2 2 3 2
2 3 2 2 3 3 3 3 2 2 3 3 3 3 2
2 2 2 2 2 2 2 2 2 2 2 2 2 2 2
