12 22 0 4
2 2 2 2 2 2 2 2 2 2 2 2 2 2 2 2 2 2 2 2 2 2
2 0 3 2 2 2 3 3 3 3 3 3 3 3 3 3 2 3 3 3 3 2
2 3 3 2 3 3 3 3 3 1 3 3 3 3 3 2 2 3 3 3 3 2
2 3 3 2 3 3 3 3 3 3 2 2 3 3 3 3 2 3 2 2 3 2
2 3 3 2 3 3 3 2 3 3 2 2 3 3 3 3 2 3 2 3 3 2
2 2 3 3 1 3 3 2 3 3 3 3 3 3 3 3 3 3 2 3 2 2
2 3 3 3 2 2 2 2 3 3 3 3 3 3 3 3 2 3 2 3 3 4
2 3 3 3 2 2 2 2 3 3 2 2 3 3 3 3 2 3 2 3 3 4
2 3 3 3 3 3 3 3 3 3 2 2 3 3 3 2 2 1 2 3 2 2
2 3 3 3 3 3 3 3 3 3 3 3 1 3 3 3 2 3 2 3 3 2
2 3 3 3 3 3 3 3 3 3 3 3 3 3 3 3 2 3 3 3 3 2
2 2 2 2 2 2 2 2 2 2 2 2 2 2 2 2 2 2 2 2 2 2
